1000000000000000000001
1000000000000000000001
1000000000000000000001
1000000000000000000001
1000000000000000000001
1000000000000000000001
1000EEEE00000000000001
1000EEEE00000000000001
1000000000000000000001
1000P000E0000000000111
1000000000000022200001
1000000000000000000001
1000000000111100000001
1000000000000000010001
1000000000000000100001
1000000002000001000001
1000000000000010000001
1000000000000012000001
1000000000001110000001
1000000000200001111111
1000000000200001000011
1000000011100001010011
1000000200001110000011
1000002000000000000011
1000220000001111111111
1111111111111111111111
1111111111111111111111
1